1111111111111111111111111111111
1EC0PC0000000000000000000000001
10C0CC0110E00000001110000110001
1000C00011110001010101000001101
10010C0010010001100011000100001
1000000000C000000C0000000000001
1111111111111111111111111111111
