1111111111111111111111111111111
10C0P00000000000000000000001111
1000000110000000011111001110001
1100C00011110001110001000000101
10010C0010010000011C01000110101
1101110000C001000C10000011C01E1
1111111111111111111111111111111
